############################################################
#..........................................................#
#...............*.*.*......................................#
#..........................................................#
#..........................................................#
#................##........................................#
#................##........................................#
#................##........................................#
#................##........................................#
#................##........................................#
#................##........................................#
#................##........................................#
#..P...***.......##...........^^^^^^..................D....#
############################################################
############################################################
