############################################################
#..........................................................#
#..........................................................#
#..........................................................#
#..........................................................#
#..........................................................#
#..........................................................#
#..........................................................#
#..........................................................#
#..........................................................#
#.......................*.............*....................#
#.............##......=====.........=====..................#
#..P....*.....##...C..........#.............C..*..#....D...#
############################################################
############################################################
