################################################################
#...................vvvvv...............vvvvv..................#
#...........*...................*...................*..........#
#..............................................................#
#..............................................................#
#..............................................................#
#..............................................................#
#....*................*...................*....................#
#..P......^^^^^...............^^^^^...............^^^^^...D....#
################################################################
################################################################
################################################################
################################################################
################################################################
################################################################
